NO ./text/texture.xpm
SO ./text/texture.xpm
EA ./text/texture.xpm
WE ./text/texture.xpm

F 220,100,1
C 220,0,30

111111
100001
111111
      111111111                
     11000000011
    1100000000011
    10001111111111
 11110011        1
110010011        1
110010011        1
110010001111111111
11001000000000001
11001000000000001
1100100000N000001
11001000000000001
11001000000000001
 1111000011110001
    100001 100001
    100001 100001
    111111 111111
