NO ./text/pokeball.xpm
SO ./text/smiley.xpm
EA ./text/flower.xpm
WE ./text/bricks.xpm

F 64,64,64
C 0,0,255


1111111111111111111111111111111111111111111111111111111111111111111111111111111111111111111111111111
1111111000000000000000000000000000000000000000000000000000000000000000000000000000000000000000111111
1111110000000000000000000000000000000000000000000000000000000000000000000000000000000000000000011111
1111100000000000000000000000000000000000000000000000000000000000000000000000000000000000000000001111
1111000000000000000000000000000000000000000000000000000000000000000000000000000000000000000000000111
1110000000000000000000000000000000000000000000000000000000000000000000000000000000000000000000000011
1100000000000000000000000000000000000000000000000000000000000000000000000000000000000000000000000011
1000000000000000000000000000000000000000000000000000000000000000000000000000000000000000000000000001
1000000000000000000000000000000000000000000000000000000000000000000000000000000000000000000000000001
1000000000001111111111111111111111111111111111111111111111111111111111111111111111111000000000000001
1000000000001                                                                       1000000000000001
1000000000001                                                                       1000000000000001
1000000000001                                                                       1000000000000001
1000000000001                                                                       1000000000000001
1000000000001                                                                       1000000000000001
1000000000001                                                                       1000000000000001
1000000000001                                                                       1000000000000001
1000000000001                                                                       1000000000000001
1000000000001                                                                       1000000000000001
1000000000001                                                                       1000000000000001
1000000000001                                                                       1000000000000001
1000000000001                                                                       1000000000000001
1000000000001                                                                       1000000000000001
1000000000001                                                                       1000000000000001
1000000000001                                                                       1000000000000001
1000000000001                                                                       1000000000000001
1000000000001                                                                       1000000000000001
1000000000001                                                                       1000000000000001
1000000000001                                                                       1000000000000001
1000000000001                                                                       1000000000000001
1000000000001                                                                       1000000000000001
1000000000001                                                                       1000000000000001
1000000000001                                                                       1000000000000001
1000000000001                                                                       1000000000000001
1000000000001                                                                       1000000000000001
1000000000001                                                                       1000000000000001
1000000000001                                                                       1000000000000001
1000000000001                                                                       1000000000000001
1000000000001                                                                       1000000000000001
1000000000001                                                                       1000000000000001
1000000000001111111111111111111111111111111111111111111111111111111111111111111111111000000000000001
1000000000000000000000000000000000000000000000000000000000000000000000000000000000000000000000000001
1000000000000000000000000000000000000000000000000000000000000000000000000000000000000000000000000001
1100000000000000000000000000000000000000000000000000000000000000000000000000000000000000000000000011
1110000000000000000000000000000000000000000000000000000000000000000000000000000000000000000000000011
111100000000000000000000000000000000000000000000W000000000000000000000000000000000000000000000000111
1111100000000000000000000000000000000000000000000000000000000000000000000000000000000000000000001111
1111110000000000000000000000000000000000000000000000000000000000000000000000000000000000000000011111
1111111000000000000000000000000000000000000000000000000000000000000000000000000000000000000000111111
1111111111111111111111111111111111111111111111111111111111111111111111111111111111111111111111111111
