NO ./texture_north
SO ./texture_south
WE ./texture_west
EA ./texture_east

F 220,,100,0
C 225,30,0

    111111111
    1101  101
11 1100111111
1111000000001
1000000000001
1111110000001
    111100001
       100111
       1001
       1111





      111111111
     11000000011
    1100000000011
    10001111111111
    10011        1
 11110011        1
110010011        1
110010001111111111
11001000000000001
11001000000000001
11001000000000001
11001000000000001
11001000000000001
 1111000011110001
    100001 100001
    100001 100001
    111111 111111
