NO ./text/bricks.xpm
SO ./text/smiley.xpm
EA ./text/flower.xpm
WE ./text/random.xpm

F 64,64,64
C 0,0,255

111111
100001
111111
      111111111                
     110000000111111111111111111111111111
    1100000000020000000000000000000000001
    1000111111111111111111111111111111111
 11110011        1
110010011        1
110010001111111111
11001000000000001
11001000000000001
11001000000000001
11001000000000001
11001000000000001
 1111000011110001
    10N001 100001
    100001 100001
    111111 111111
