NO ./text/pokeball.xpm
SO ./text/smiley.xpm
EA ./text/flower.xpm
EA ./text/flower.xpm

F 64,64,64
C 0,0,255


11111111111111111111111111111111
10000000000000000000000000000001
10000000000000000000000000000001
10000000000000000000000000000001
10000000000000000000000000000001
10000000000111111111111000000001
100000000011          1100000001
10000000011            110000001
1000000001              10000001
1000000001              10000001
1000000001              10000001
1000000001              10000001
1000000001              10000001
1000N00001              10000001
1000000001              10000001
1000000001              10000001
10000000011            110000001
100000000011          1100000001
10000000000111111111111000000001
10000000000000000000000000000001
10000000000000000000000000000001
10000000000000000000000000000001
10000000000000000000000000000001
11111111111111111111111111111111
